48 20
Sxx1xxx10101010001000100000010000100001000111001
000x111xxxxxx01101110001110000110010001000100001
1011100000110x1001111111100001000000010100110110
00010011000100xx10011100001101011111100111000100
0111011101000101xxx10001010100010010000000001110
0010011011001100011x1001000001011011001001100110
01000010000100010110xxxxxx1000011011010101010001
10100010000100000100101100xxxx110010000000110000
100000100100011101000001111000xx0000010001010000
01110010000100000000001100101000x100010101001100
000100011111000001011010010000010xx1100000000111
01011010011010100100000000010110000xxx1000000000
10110000000000101111000000100000100110x101110111
000001001100000101011000001100001001000xx0000100
00000110000000000101001010000110010000101x110011
100110101010001000100010111110001010000100xx0010
00010001010001011100110001101110000011000000x010
010001011100000100100010000100000000000010000x00
0011000000000001110111000010000100001011001110x0
01110100000001101110000100000100100100010111000T
