64 40
1000000000000000000000000000000000000000000000000000000000000001
0000000000000000000000000000000000000000000000000000000000000000
0000000011000000000000000000000000000000000000000000000000000000
0000000011000000000000000000000000000000000000000000000000000000
0000000011000000000000000000000000000000000000000000000000000000
0000000011000000000000000000000000000000000000000000000000000000
0000000011000000000000000000000011000000000000000000000000000000
0000000011000000000000000000000011100000000000000000000000000000
0000000011000000000000000000000001110011000000000000000000000000
0000000011000000000000000000000000111011000000000000000000000000
0000000011000000000000000000000000011110000000000000000000000000
0000000011100000000000000000000000001100000000000000000000000000
0000000011111111111111110000000000111011000000000000000000000000
0000000011111111111111110000000000110011000000000000000000000000
0000000000000000000001110000000000000000000000000000000000000000
0000000000000000000000110000000000000000000000000000000000000000
0000000000000000000000110000000000000000000000000000000000000000
0000000000000000000000111000000000000000000000000000000000000000
0000000000000000000000111111111111111100000000000000000000000000
0000000000000000000000111111111111111100000000000000000000000000
0000000000000000000000000000000000011100000000000000000000000000
0000000000000000000000000000000000001100000000000000000000000000
0000000000000000000000000000000000001100000000000000000000000000
0000000000000000000000000000000000001110000000000000000000000000
0000000000000000000000000000000000001111110000000000000000000000
0000000000000000000000000000000000001111110000000000000000000000
0000000000000000000000000000000000000000000000000000000000000000
0000000000000000000000000000000000000000000000000000000000000000
0000000000000000000000000000000000000000000000000000000000000000
0000000000000000000000000000000000000000000000000000000000000000
0000000000000000000000000000000000000000000000000000000000000000
0000000000000000000000000000000000000000000000000000000000000000
0000000000000000000000000000000000000000000000000000000000000000
0000000000000000000000000000000000000000000000000000000000000000
0000000000000000000000000000000000000000000000000000000000000000
0000000000000000000000000000000000000000000000000000000000000000
0000000000000000000000000000000000000000000000000000000000000000
0000000000000000000000000000000000000000000000000000000000000000
0000000000000000000000000000000000000000000000000000000000000000
1000000000000000000000000000000000000000000000000000000000000001
